board start,
  "D*AC********B** ",
  "D*CA********B** ",
  "D**A***C****B** ",
  "D**C**A*****B** ",
  "DC*****A****B** ",
  "D*C****A****B** ",
  "D**C***A****B** ",
  "D****C*A****B** ",
  "D******A****B*C ",
  "D*C****A*****B* ",
  "D**C***A*****B* ",
  "D*C****A******B ",
  "D**C***A******B ",
  "D**B****A***C** ",
  "D**B*****A**C** ",
  "DB*********A**C ",
  "D*B********A**C ",
  "D*CB*******A*** ",
  "D**B**C****A*** ",
  "D***B******A**C ",
  "DC*****B***A*** ",
  "D*C****B***A*** ",
  "D**C****B**A*** ",
  "D*******B**A**C ",
  "D**C*****B*A*** ",
  "DC********BA*** ",
  "D*C*******BA*** ",
  "D***C*****BA*** ",
  "D*******C*BA*** ",
  "DC*********AB** ",
  "D*C********AB** ",
  "D**C*******AB** ",
  "D***C******AB** ",
  "D****C*****AB** ",
  "D*****C****AB** ",
  "D******C***AB** ",
  "D*******C**AB** ",
  "D********C*AB** ",
  "D**********ABC* ",
  "D**********AB*C ",
  "DC*********A*B* ",
  "D*C********A*B* ",
  "D***C******A*B* ",
  "D*******C**A*B* ",
  "D*********CA*B* ",
  "D**********ACB* ",
  "CD*********A**B ",
  "C***D******A**B ",
  "DC*********A**B ",
  "D*C********A**B ",
  "D**C*******A**B ",
  "D***C******A**B ",
  "*D**C******A**B ",
  "D****C*****A**B ",
  "D*****C****A**B ",
  "D******C***A**B ",
  "D*******C**A**B ",
  "D********C*A**B ",
  "D**********AC*B ",
  "*D*********AC*B ",
  "D**B****C***A** ",
  "D**B********AC* ",
  "D**BC********A* ",
  "D**B*C*******A* ",
  "D**B****C****A* ",
  "D**B*******C*A* ",
  "D**B********CA* ",
  "D******BC****A* ",
  "D******B****CA* ",
  "D*******C**B*A* ",
  "D**********BCA* ",
  "DB*********C**A ",
  "D*B********C**A ",
  "D*B*********C*A ",
  "DC*B**********A ",
  "D*CB**********A ",
  "D**BC*********A ",
  "D**B*C********A ",
  "D**B**C*******A ",
  "D**B***C******A ",
  "D**B****C*****A ",
  "D**B*****C****A ",
  "D**B*******C**A ",
  "D**B********C*A ",
  "D**B*********CA ",
  "D***B******C**A ",
  "D*****B*****C*A ",
  "DC*****B******A ",
  "D*C****B******A ",
  "D**C***B******A ",
  "D***C**B******A ",
  "D******BC*****A ",
  "D******B**C***A ",
  "D*******B**C**A ",
  "DC********B***A ",
  "D*C*******B***A ",
  "D***C*****B***A ",
  "D*******C*B***A ",
  "CD*********B**A ",
  "C***D******B**A ",
  "DC*********B**A ",
  "*C**D******B**A ",
  "D*C********B**A ",
  "D**C*******B**A ",
  "***CD******B**A ",
  "D***C******B**A ",
  "D****C*****B**A ",
  "D*****C****B**A ",
  "D*******C**B**A ",
  "D********C*B**A ",
  "D**********BC*A ",
  "D**********B*CA ",
  "D*******C***B*A ",
  "D********C**B*A ",
  "D***C********BA ",
  "D*******C****BA ",

